15 17
#################
#--..--)---a...-#
#..#)---#-----.=#
#--#--=.#-.#---.#
#...-.-.-#-...-=#
#.-.-#--#---.-=-#
#-.-....#-#.C.--#
#.B.....#--...==#
#..---.D...--.==#
#..-E#--.-#--.=-#
#.A.--..#.---.-.#
#...-.-.--.-.==.#
#..#-#--#-.-.==.#
#............-=.#
#################